#                                #
#                                #
#          ###                   # 
#            #                   #
#           #                    #
#          ###                   #
#                                #
#############H####################