
#                 #######           #
#  ####  ####  #  #######  ####  #  #
#     #     #  #  #  #     #     #  #
####  ##########  #  #######  #  ####
#  #  #  #                 #  #     #
#  #  #  ####  #######  #  #######  #
#  #        #     #     #  #        #
#  #  #######  #  ####  #  #######  #
#        #  #  #  #  #  #           #
#######  #  ####  #  #############  #
#     #     #     #              #  #
#  #  ####  #  ####  #  ####  ####  #
#  #        #  #     #  #           #
#  #######  #  ####  ####  #  #######
#  #        #  #     #  #  #  #  #  #
####  #######  #  ####  #######  #  #
#  #  #        #        #           #
#  #######  ##########  #  #  #######
#        #        #  #  #  #  #     #
####  #######  ####  #  #  #  ####  #
#  #  #  #        #        #        #
#  #  #  #  ####  #  #  #  ####  ####
#           #     #  #  #  #        #
